##############   ##########
#............#####........#
#............/.../........#
#..P........./.../........#
#............#####........#
##############   ####//####
                    #..#
                    #..#
                    ....
                    ....
                    ....