##############   ##########
#............#   #........#
#............#####........#
#..P........./.../........#
#............#####........#
##############   ##########